11111
1C0001
10P001
100E01
11111