111111111111111
100000K00000P01
1KC111K00K00001
111111111111101
111100000000101
101000C00011101
101000100000001
110C0E111111111
111000000000001
111111111111111
