1111111111111111111111111111111111
1P1C000K0K0K000CK0000CK0000K000001
101K01010000C0C01010010C000K010101
100001000KCKC0CC0010K1000000010101
1E000000KKKCCK00000K00000K00000KC1
1111111111111111111111111111111111